OOOOOOOOOOOOOOOOOOOOOOOO
OOOOOOOOOOOOOOOOOOOOOOOO
OOOOOOEOO######OOEOOOOOO
OO######OOOOOOOO######OO
EOOOOOOOOOOOOOOOOOOOOOOE
#####OOOOOOOOOOOOOO#####
OOOOOO###OEOOEO###OOOOOO
OOOOOOEOOO####OOOEOOOOOO
########OOOOOOOO#####OOO
OOOOOOOOOOOOOOOOOOOOOOOO
O####OOOO######OOO######
OOOOOOOOOOAOBOOOOOOOOOOO
########################