OOOOOOOOOOOOOOOOOOOOOOOO
OOOOOOOOOOOEOOOOOOOOOOOO
OOOOOOO###########OOOOOO
OOOOOOEOOOOOOOOOOEOOOOOO
OOOO################OOOO
OOOEOOOOOOOOOOOOOOOOEOOO
#########OOOOO##########
OOOOOEOOOOOOOOOOOOEOOOOO
OOOO#####OOOOO######OOOO
OOOOOOOOOOOOOOOOOOOOOOOO
####OOOO#######OOOO#####
OOOOOAOOOOOOOOOOOOOOOOBO
########################