OOOOOOOOOOOOOOOOOOOOOOOO
OOOOOOOOOOOOOOOOOOOOOOOO
############OOOOOOOOOOOO
OOOOOOOOOOOOOOOOOOOOOOOO
OO############OOOOOOOOOO
OOOOOOOOOOOOOOOOOOOOOOOO
############OOOOOOOOOOOO
OOOOOOOOOOOOOOOOOOOOOOOO
OO############OOOOOOOOOO
OOOOOOOOOOOOOOOOOOOOOOOO
############OOOOOOOOOOOO
OAOBOOOOOOOOOOOOOOOOOOOO
########################