OOOOOOOOOOOOOOOOOOOOOOOO
OOOOOOOEOOOOOOOOHOOOOOHO
OOOOO###################
OOOOOOOOOOOOOOOOHOOOOOOO
OOOOOOOOOOOO##########OO
OFOOO######OOOOOOOOOOOOO
####OOOOOOOOOOOOOOFOOOOO
OOOOOOOO##############OO
#####OOOOOOOOOOOOOOOOOOO
OOOOOO#######OOOGOOOOGOO
OOOOOOOOOOOOOO##########
OOOOOOOOAOBOOOOOOOOOOOOO
########################