OOOOOOOOOOOOOOOOOOOOOOOO
OOOOOOOOOOOOOOOOOOAOOOBO
OOEOOOOOOOOOOOO#########
O#######OOOOOOOOFOOOOOOO
OOOOOOOGOOOOO#######OOOO
OOO#######OOOOOOOOOOOOOO
OOOOOOOOOOO##########OOO
OOOOOOOOHOOOOOOOOOOOOOOO
OOOO########OOOOOOOOOOOO
OOOOOOOOOOOOO####OOOOOOO
OOOOOOO#####OOOOOO#####O
OEOOOOOFOOOOOOOOOOGOOOHO
########################