OOOOOOOOOOOOOOOOOOOOOOOO
OOEOOOOOOOOOOOOOOOOOOOFO
#########OO####OOOO#####
OOOOOOOOOOOHOOOOOHOOOOOO
OOOOOO#############OOOOO
OGOOOOOOOOOOOOOFOOOOOOOO
####OOOOOOOO######OOOOOO
OOOOOO####OOOOOOOOOOEOOO
#####OOOOOOOOO##########
OOOOOOOO#####OOOOOOOOOOO
######OOOOOOOO######OOOO
OOAOOOOOOOOOOOOOOOBOOOOO
########################