OOOOOOOOOOOOOOOOOOOOOOOO
OOOOOOOOOOOOOOOEOOOOOOOO
OOOOOOOOOOOEOO####OOOOOO
OOOOOOEOO####OOOOEOOOOEO
OOOO####OOOOOOO#########
OOOOOOOOOOOOOOOOOOOOOOOO
OOOOOOOOOOOOO####OOOOOEO
OOO###OOOOEOOOOOOO######
OOOOOOO########OOOOOOOOO
##OOOOOOOOOOOOOOOOOO####
OOO#######OOOO#####OOOOO
OOOOOAOOOOOOOOOOOOOOOOBO
########################
