OOOOOOOOOOOOOOOOOOOOOOOO
OOOOOOOOOOOOOOOOOOOEOOOO
#######OOOOOOOOOO#######
OOOOOOOOOOEOOOEOOOOOOOOO
OOO####OO######OO####OOO
OOOOOOOOOOOOOOOOOOOOOOOO
######OOOOOOOOOOOO######
OOEOOOOOOOOOOOOOOOOOOEOO
####OOO##########OOO####
OOOOOOOOOOOOOOOOOOOOOOOO
######OOOOOOOOOOOO######
OOOOOOOOOOAOBOOOOOOOOOOO
########################