OOOOOOOOOOOOOOOOOOOOOOOO
EOOOOOOOOOOOOOOOOOOOOOEO
#####OOOOOOOOOOOO#######
OOOOOOOO########OOOOOOOO
O#####OOOOOOOOOOOOOOOOOO
OOOOOOOOOOO#######OOOOOO
#####OOOOOOOOOOHOOOOHOHO
OFOOOOOOOOOO############
#####OO####OOOOOOOOOOOOO
OOOOOOOOOOOOOOOOOOGOOOOO
OO#########OOO######OOOO
OOAOOOOOOOBOOOOOOOOOOOOO
########################