OOOOOOOOOOOOOOOOOOOOOOOO
OOOEOOOOOOOOOOOOOOOEOOOO
#######OOOOOOOOOO#######
OOOOOOOOOEOOOOOOEOOOOOOO
OOOOOOO####OO####OOOOOOO
OOOOOOOOOOOOOOOOOOEOOOOO
OOOO######OOO#######OOOO
OOOOOOOOOOEOOOOOOOOOOOOO
OO######OO####OO######OO
EOOOOOOOOOOOOOOOOOOOOOOO
######OOOOOOOOOOOO######
OOOOOOOOOOAOBOOOOOOOOOOO
########################