OOOOOOOOOOOOOOOOOOOOOOOO
OOOOOOOOOOOOOOOOOOOOOOFO
OOOOO###OOOOOOOOOOO#####
OEOOOOOOOOO#####OOOOOOGO
#########OOOEOOOFOOO####
OOOOOOOOOOO#######OOOOOO
######OOOOOOOOOOOOOOOOHO
OOOOOOO###OOOBOO########
####OOOOOOO####OOOOOOOOO
OOOOOOOOOOOOOOOOOOOOOOOO
##OOOOO#####OO######OOOO
OOOOOAOOOOOOOOOOOOOOOOOO
########################
