OOOOOOOOOOOOOOOOOOOOOOOO
OOOOOOOOOOOOOOOOOOOOOOOO
OOOO###OOO###OOOOO###OOO
OOOEOOOOOOOEOOOOOOOEOOOO
OO####OOO#####OOOO####OO
OOOOOOOOOOOOOOOOOOOOOOOO
##########OOOO##########
OEOOOOOOOOOEOOOOOOOOOOEO
####OOOO#######OOOO#####
OOOOOOOOOOOEOOOOOOOOOOOO
####OOOOO#####OOOOO#####
OOOOOAOOOOOOOOOOOOOOOOBO
########################