OOOOOOOOOOOOOOOOOOOOOOOO
OOOOOOOOOOOOOOOOOOOOOOOO
OOOOOOOOO######OOOOOOOOO
OOOOOOOOOOOOOOOOOOOOOOOO
OOOOOO##################
OOOOOOOOOOEOOEOOOOOOOOOO
##############OOOOOOOOOO
OOOOOOOOOOOOOOOOOOOOOOOO
OOOOOOO###OOOO#####OOOOO
OOOOOEEOOOOOOOOOEEOOOOOO
OOOO######OOOO########OO
OOOOOOOOOOAOBOOOOOOOOOOO
########################