OOOOOOOOOOOOOOOOOOOOOOOO
OOOOOOEOOOOOOOOOEOOOOOOO
OOOO################OOOO
OOOOOOOOOOOEOOOOOOOOOOOO
######OOO######OOO######
OOOOOOOEOOOOOOOOEOOOOOOO
OOOOO##############OOOOO
OOOOOOOOOOOOEOOOOOOOOOOO
OOOOOOOO########OOOOOOOO
OOOOOOOOOOOOOOOOOOOOOOOO
OOOOOOOOOO####OOOOOOOOOO
OOOOOAOOOOOOOOOOOOOOOOBO
########################