OOOOOOOOOOOOOOOOOOOOOOOO
OOOOOOOOOOOHOOOOOOOOOOOO
OOOO###OO#####OOO###OOOO
OOOOOOOOOOOOOOOOOOFOOOOO
OOOO###OO#####OOO###OOOO
OOOOOOOOOOOFOOOOOOOOOOOO
OOO###OO#######OOO###OOO
OOOGOOOOOOOOOOOOOOOOHOOO
O#####OO#######OOO#####O
OOOOOOOOOOOHOOOOOOOOOOOO
#####OOO#######OOO######
OOOOOAOOOOOOOOOOOOOOOOBO
########################