OOOOOOOOOOOOOOOOOOOOOOOO
OOGOOOOOOOOOOOOOOOOEOOOO
#######OOOOOGOOOO#######
OOOOOOOOOO####OOOOOOOOOO
OOO####OOOOOOOOOO####OOO
OGOOOOOOO######OOOOOOOFO
######OOOOOOOOOOOO######
OOOOOOOOOOOGOOOOOOOOOOOO
OOOOOOO##########OOOOOOO
OOOOOOOOOOOOOOOOOOOOOOOO
########OOOOOOOO########
OOOOOOOOOOAOBOOOOOOOOOOO
########################